00000000000000000000000000000000000000000000000000000
00000000000000000000000000000000000000000000000000000
00000000000000000000000222000000000000000000000000000
00000000000000022222002111000000000000000000000000000
00000002222200000000001100000000000000000000009000000
00000000000000000000000000000000002222200000009000000
22200000000000000220000002200000021100000002222200000
11122222222222222110002221120000000000000011111122000
11111111111111111110001111110000000000000000011111000
11111111111111111100000111000000000002222000000100000
01111111111111111100000010000000222221111222200000000
01111111111111000000000010000222111111111111122000000
00111111100000000000000000000000011111111111111000000
00000000000000000000000000000000000001111111000000000
00000000000000000000000000000000000000000000000000000
00000000000000000000000000000000000000000000000000000
