00000000000000000000000000000000000000000000000
00000000000000000000000000000000000000000000000
00000000000000000000000000000000000000000000000
00000000000000000000000000000000000000000000000
00000000000000000000011111000000000000000000000
00000000000000000000000000000000000000000000000
00000000000000001110000000001110000000000000000
00000000000000000000000000000000000000000000000
00000000000111000000000000000000011100000000000
00000000000000000000000000000000000000000000000
00000000000000001111111111111110000000000000000
00000000000000001000000000000010000000000000000
00000000000000001000000000000010000000000000000
00000000000000001000000000000010000000000000000
00000000000000001000000000000010000000000000000
00000000000000001000000000000010000000000000000
00000000000000001000000000000010000000000000000
00000000000000001000000000000010000000000000000
